174;175;175;174;176;176;176;176;176;176;15;
175;174;175;176;176;176;5;176;176;178;178;
175;176;176;5;176;176;176;176;176;178;42;
176;176;176;176;176;176;6;176;176;178;178;
176;5;176;176;176;176;176;176;6;178;176;
176;176;176;176;176;174;174;176;174;5;178;
5;176;176;6;176;174;174;174;174;174;176;
